3 7 1 4 8 2 6 0 9 5
2 4 6 8 0 1 3 5 7 9
1 3 5 7 9 0 2 4 6 8
0 2 4 6 8 1 3 5 7 9
9 8 7 6 5 4 3 2 1 0
5 4 3 2 1 0 9 8 7 6
6 7 8 9 0 1 2 3 4 5
7 6 5 4 3 2 1 0 9 8
8 9 0 1 2 3 4 5 6 7
4 5 6 7 8 9 0 1 2 3
