0 0 0 0 1 1 1 2 2 3
0 0 0 1 1 1 2 2 3 4
0 0 1 1 2 2 3 3 4 5
0 1 1 2 2 3 3 4 5 6
1 1 2 2 3 3 4 4 5 6
1 2 2 3 3 4 4 5 5 6
2 2 3 3 4 4 5 5 6 7
2 3 3 4 4 5 5 6 6 7
3 3 4 4 5 5 6 6 7 8
4 4 5 5 6 6 7 7 8 9
